NO textures/stonewall1.xpm
SO textures/stonewall1.xpm
WE textures/stonewall1.xpm
EA textures/stonewall1.xpm

F 70,70,70
C 150,150,255

111111111111111
10000V000000001
1000111111100V1
100010000010001
1000100N0020001
100010000010001
1000111111100V1
100000000000001
111111111111111