NO textures/stonewall1.xpm
SO textures/stonewall1.xpm
WE textures/stonewall1.xpm
EA textures/stonewall1.xpm

F 112,128,144
C 135,206,235

111111111111111
1E0001000100V01
1110V1111101110
100001000101000
101111110101111
1000000000V0001
101111111111101
100000000000001
101111101111101
1000V0100000001
111101101111111
100000000000001
111111111111111