NO textures/stonewall1.xpm
SO textures/stonewall1.xpm
WE textures/stonewall1.xpm
EA textures/stonewall1.xpm

F 101,67,33
C 70,70,70

111111
100001
10N001
100001
111111