NO textures/stonewall1.xpm
SO textures/stonewall1.xpm
WE textures/stonewall1.xpm
EA textures/stonewall1.xpm

F 180,180,180
C 100,100,100

          
     11111  
    100S001
     10001
      121
       1
